index.tree.tsv	📝 树状视图注释
__comment__	注释文件根
src	源代码目录
.gitignore	🔕 Git 忽略文件配置
public	公共资源根
index.html	项目入口视图
package.json	项目包管理
README.md	🔖 自述文件
vite.config.ts	Vite 插件配置
assets	静态资源目录
components	组件库
hooks	自定义钩子
pages	业务界面
utils	工具模块
App.tsx	App 根组件
main.tsx	项目逻辑入口
vite-env.d.ts	Vite 路径配置
resource.ts	资源管理模块
tsconfig.app.json	类型检查配置
router.tsx	路由管理模块
config.ts	配置管理模块
tsconfig.json	TS 配置文件入口
tsconfig.node.json	Node 配置
Buttons	按钮类组件
.idea	IDE 配置目录

audios	音频
soundEffects	音效
fonts	字体
images	图片
styles	样式表
videos	视频
